SO textures/wall_south.xpm
WE textures/wall_west.xpm
EA textures/wall_east.xpm

F 34,139,34
NO textures/wall_north.xpm
C 135,206,235

11111111111111
10000000000001
1S000000000001
10000011000001
10000011000001
10000000000001
10000000000001
11111111111111