
SO textures/wall_south.xpm
WE textures/wall_west.xpm
EA textures/wall_east.xpm

F 34,139,34
NO textures/wall_north.xpm
C 135,206,235



    111111111111111111
    100000000000000001
1111100010000000000001
1001000011010000011111  111111111
100000001101000001      100000001
100010001001N00001      100000001
100000001101000001      100000001
100000000000000001      100000001
111111111111111111      111111111
1


111
101
111