NO textures/Tile_1.xpm
SO textures/Tile_2.xpm
WE textures/Tile_3.xpm
EA textures/Bricks_1.xpm

F 255,255,255
C 0,255,0

111111111111111111
100000000000000001
100010000000000001
100100001101000001
100000001101000001
100010001001000001
100000001101000001
100000000000000001
111111111111111111