
SO textures/wall_south.xpm
WE textures/wall_west.xpm
EA textures/wall_east.xpm

F 34,139,34
NO textures/wall_north.xpm
C 135,206,235



    111111111111111111
    100000000000000001
1111100010000000W00001
1001000011010000011111
100000001101000001
100010001001000001
100000001101000001
100000000000000001
111111111111111111