WE                     textures/checker_west.xpm
NO textures/checker_north.xpm
SO    textures/checker_south.xpm


C 135,206,235
EA textures/checker_east.xpm

F     34,139,34

1111
10N1
1111