NO ./textures/red_bricks.xpm
SO ./textures/Glowing_Square_Tile_64x64.xpm
WE ./textures/Brick_Wall_64x64.xpm
EA       ./textures/Wooden_Floor_Vertical_64x64.xpm
F 119,207,224

C 119,207,238


1111111111
1111111111
1111111111
1111111101
1111111111
10000N1001
11111111111
1111111111
1111111111
1111111111
1