NO ./textures/red_bricks.xpm
SO ./textures/Glowing_Square_Tile_64x64.xpm
WE ./textures/Brick_Wall_64x64.xpm
EA       ./textures/Wooden_Floor_Vertical_64x64.xpm
F 119,207,224

C 119,207,238


 11       111111111111111111111111
101
111
        1001000000000000000000011
11111111101100001110000000000001
100000000011000001110111111111111
11110111111111011100000010001
11110111111111011101010010001
11000000110101011100000010001
11111111111111111111110000011
111111        N        1000011
11111111111111111111111100011
10000000000000000000000000011
10000000000000000001010010001
11000001110101011111011110001111111
11110111 1110101 101111010001
111 1111111 111111111111111111
1111111111111111111111111111111
1111111111111111111111111111111111111111
11
11111