SO textures/wall_south.xpm
WE textures/wall_west.xpm
EA textures/wall_east.xpm

F 34,139,34
NO textures/wall_north.xpm
C 135,206,235

111111111111
100000000001
100000000001
100000E00001
100000000001
111111111111