WE                     textures/wall_west.xpm
NO textures/wall_north.xpm
SO    textures/wall_south.xpm


C 135,206,235
EA textures/wall_east.xpm

F     34,139,34


11111111111
1N000000001
10000000001
10000000001
10000000001
10000000001
10000000001
10000000001
10000000001
10000000001
10000000001
10000000001
10000000001
10000000001
10000000001
10000000001
10000000001
10000000001
10000000001
10000000001
10000000001
10000000001
10000000001
10000000001
10000000001
10000000001
10000000001
10000000001
1111111111111111