NO ./textures/foe_idle_front_1.xpm
SO ./textures/item_0.xpm
WE ./textures/player_walk_front_0.xpm
EA ./textures/wall_0.xpm

F 0,100,0
C 20,0,200

111111111111
10000N000001
100000000001
100000000001
100000000001
111111111111